NO textures/wall.xpm
SO textures/wall_other.xpm
WE textures/wall.xpm
EA textures/floor.xpm

F 250,250,100
C 34,2,200

111111111111111111111
100000001000000000001
101010101011111110001
100010100010000010001
111110101111101011101
100000101000101000001
101111101011101111111
101000001010100000101
101011111010111110101
10101000101010001010111
101110101010101010101001
10000010101000101000111
111111101011111011101
100000101000100010001
101110101110101110111
101000100000100010101
101011111111111010101
100010000000000010001
111010111011111111101
1W0000001000000000001
111111111111111111111
