NO textures/wall.xpm
SO textures/wall.xpm
WE textures/wall.xpm
EA textures/wall.xpm

F 0,255,34
C 34,2,200

111111111111
10000000000111111111111111
1111000000000000000000000011110111
111111111000000000000000000011111111111
111110000000000000000000000011
11111000000000000000N00000011
111110000000000000000000000011
11111111111111111111111111111
