NO textures/barril.xpm
SO textures/wall.xpm
WE textures/wall.xpm
EA textures/floor.xpm

F 0,255,34
C 34,2,200

111111111111
10000000000111111111111111
111100000000000000000000001111111
111111111000000000000000000011111111111
11111000000000000000000000001111111
11111000000000000000N000000100000001
11111000000000000000000000001111111
11111111111111111111111111111
