NO textures/wall.xpm
SO textures/wall.xpm
WE textures/wall.xpm
EA textures/wall.xpm

F 0,255,34
C 34,2,200

111111111111
10000000000111111
1111000000011110111
11111111100000011
1111100000N11111
111111111111
