111111
111111
111111
000000
N  
11111111111
1111   11
			11
			11111
000000